1 13 31
###############################
# p        w F B r s f b      #
#                             #
#         #w#                 #
#                  x          #
#      F***s********          #
#      #f#  r*  2     B *     #
#     *b*    *******          #
#         * 1                 #
#                             #
#                             #
#                             #
###############################
