1 13 31
###############################
# p                           #
#                             #
#         #w#                 #
#                  x          #
#      F***s********          #
#      #f#  r* 2 B *          #
#     *b*    *******          #
#         * 1                 #
#                             #
#                             #
#                             #
###############################
