1 13 31
###############################
#p     **i * k *      * * *   #
# # # #*# # #*#*# # # #*#*#*# #
#  x  d   ***  *   br *   * * #
#  x  d   ***  *   br *   * * #
# # # # # #*# # #*#*# # # # #*#
#fm    2  s  **  *  *    j    #
# # # # # # # # # #*# #*# # # #
#*  *  ?   *  *      *  a     #
# # # # #*# # # #*#*# # # # # #
#*    **  *       *     i     #
# #*# # # # # # #*# # # # # # #
#    j      *   *  *          #
###############################