1 13 31
###############################
# p                           #
#                             #
#                             #
#                             #
#            *******          #
#            * 2   *          #
#            *******          #
#                             #
#                             #
#                             #
#                             #
###############################
