1 13 31
###############################
#p     **i * j *      * * *   #
# # # #*# # #*#*# # # #*#*#*# #
#  x  o   ***  *   br *   * * #
# # # # # #*# # #*#*# # # # #*#
#fm   a    s **  *  *         #
# # # # # # # # # #*# #*# # # #
#*  *  ?   *  *      *        #
# # # # #*# # # #*#*# # # # # #
#*    **  *       *           #
# #*# # # # # # #*# # # # # # #
#           *   *  *          #
###############################