1 13 31
###############################
# p                           #
#                             #
#                  2          #
#                             #
#                             #
#            2   1            #
#                             #
#                             #
#                   1         #
#                             #
#                             #
###############################
