1 13 31
###############################
#p     ****  1 *   *  * * *   #
# # # #*# # # # # # # #*#*#*# #
#  x*    m  o a       *   * * #
# # # # # #*# # #*#*# # # # # #
#f  r  i   k    2             #
# # # # #d# # # # #*# # # # # #
#*  *      *  *               #
# # # # #*# # # #*# # # # # # #
#*   j    *       *           #
# #*# # # # # # #*# # # # # # #
#           *   *  *          #
###############################
