1 13 31
###############################
#p     **i *   *      * * *   #
# # # #*# # #*#*# # # #*#*#*# #
#  x  o   ***  *   br *   * * #
# # # # # #*# # #*#*# # # # #*#
#fm       s  **  *  *    j    #
# # # # # # # # # #*# #*# # # #
#*  *  ?   *  *      *  a     #
# # # # #*# # # #*#*# # # # # #
#*    **  *       *     i     #
# #*# # # # # # #*# # # # # # #
#    j      *   *  *          #
###############################